AAAAGTT	out/sabre_AAAAGTT_R1.fq	out/sabre_AAAAGTT_R2.fq
AACCGAGA	out/sabre_AACCGAGA_R1.fq	out/sabre_AACCGAGA_R2.fq
AACGCCT	out/sabre_AACGCCT_R1.fq	out/sabre_AACGCCT_R2.fq
AACT	out/sabre_AACT_R1.fq	out/sabre_AACT_R2.fq
AATATGG	out/sabre_AATATGG_R1.fq	out/sabre_AATATGG_R2.fq
ACAAA	out/sabre_ACAAA_R1.fq	out/sabre_ACAAA_R2.fq
ACAGGGAA	out/sabre_ACAGGGAA_R1.fq	out/sabre_ACAGGGAA_R2.fq
ACCGT	out/sabre_ACCGT_R1.fq	out/sabre_ACCGT_R2.fq
ACCTAA	out/sabre_ACCTAA_R1.fq	out/sabre_ACCTAA_R2.fq
ACGACTAG	out/sabre_ACGACTAG_R1.fq	out/sabre_ACGACTAG_R2.fq
ACGTGGTA	out/sabre_ACGTGGTA_R1.fq	out/sabre_ACGTGGTA_R2.fq
ACGTGTT	out/sabre_ACGTGTT_R1.fq	out/sabre_ACGTGTT_R2.fq
ACTA	out/sabre_ACTA_R1.fq	out/sabre_ACTA_R2.fq
AGCCG	out/sabre_AGCCG_R1.fq	out/sabre_AGCCG_R2.fq
AGGAT	out/sabre_AGGAT_R1.fq	out/sabre_AGGAT_R2.fq
AGGG	out/sabre_AGGG_R1.fq	out/sabre_AGGG_R2.fq
AGTGGA	out/sabre_AGTGGA_R1.fq	out/sabre_AGTGGA_R2.fq
ATATGT	out/sabre_ATATGT_R1.fq	out/sabre_ATATGT_R2.fq
ATCGTA	out/sabre_ATCGTA_R1.fq	out/sabre_ATCGTA_R2.fq
ATGAAAG	out/sabre_ATGAAAG_R1.fq	out/sabre_ATGAAAG_R2.fq
ATGCCT	out/sabre_ATGCCT_R1.fq	out/sabre_ATGCCT_R2.fq
ATTAATT	out/sabre_ATTAATT_R1.fq	out/sabre_ATTAATT_R2.fq
ATTGA	out/sabre_ATTGA_R1.fq	out/sabre_ATTGA_R2.fq
ATTGGAT	out/sabre_ATTGGAT_R1.fq	out/sabre_ATTGGAT_R2.fq
CAGA	out/sabre_CAGA_R1.fq	out/sabre_CAGA_R2.fq
CATAAGT	out/sabre_CATAAGT_R1.fq	out/sabre_CATAAGT_R2.fq
CATCGT	out/sabre_CATCGT_R1.fq	out/sabre_CATCGT_R2.fq
CATCT	out/sabre_CATCT_R1.fq	out/sabre_CATCT_R2.fq
CCACAA	out/sabre_CCACAA_R1.fq	out/sabre_CCACAA_R2.fq
CCAGCT	out/sabre_CCAGCT_R1.fq	out/sabre_CCAGCT_R2.fq
CCATGGGT	out/sabre_CCATGGGT_R1.fq	out/sabre_CCATGGGT_R2.fq
CCGGATAT	out/sabre_CCGGATAT_R1.fq	out/sabre_CCGGATAT_R2.fq
CCTAG	out/sabre_CCTAG_R1.fq	out/sabre_CCTAG_R2.fq
CGAT	out/sabre_CGAT_R1.fq	out/sabre_CGAT_R2.fq
CGCCTTAT	out/sabre_CGCCTTAT_R1.fq	out/sabre_CGCCTTAT_R2.fq
CGCGGAGA	out/sabre_CGCGGAGA_R1.fq	out/sabre_CGCGGAGA_R2.fq
CGCGGT	out/sabre_CGCGGT_R1.fq	out/sabre_CGCGGT_R2.fq
CGCTGAT	out/sabre_CGCTGAT_R1.fq	out/sabre_CGCTGAT_R2.fq
CGCTT	out/sabre_CGCTT_R1.fq	out/sabre_CGCTT_R2.fq
CGGTAGA	out/sabre_CGGTAGA_R1.fq	out/sabre_CGGTAGA_R2.fq
CGTGTGGT	out/sabre_CGTGTGGT_R1.fq	out/sabre_CGTGTGGT_R2.fq
CTACGGA	out/sabre_CTACGGA_R1.fq	out/sabre_CTACGGA_R2.fq
CTAGG	out/sabre_CTAGG_R1.fq	out/sabre_CTAGG_R2.fq
CTATTA	out/sabre_CTATTA_R1.fq	out/sabre_CTATTA_R2.fq
CTCG	out/sabre_CTCG_R1.fq	out/sabre_CTCG_R2.fq
CTGTA	out/sabre_CTGTA_R1.fq	out/sabre_CTGTA_R2.fq
CTTCCA	out/sabre_CTTCCA_R1.fq	out/sabre_CTTCCA_R2.fq
CTTGCTT	out/sabre_CTTGCTT_R1.fq	out/sabre_CTTGCTT_R2.fq
GAACTTG	out/sabre_GAACTTG_R1.fq	out/sabre_GAACTTG_R2.fq
GAATTCA	out/sabre_GAATTCA_R1.fq	out/sabre_GAATTCA_R2.fq
GAGATA	out/sabre_GAGATA_R1.fq	out/sabre_GAGATA_R2.fq
GAGGA	out/sabre_GAGGA_R1.fq	out/sabre_GAGGA_R2.fq
GATG	out/sabre_GATG_R1.fq	out/sabre_GATG_R2.fq
GCCAGT	out/sabre_GCCAGT_R1.fq	out/sabre_GCCAGT_R2.fq
GCGGAAT	out/sabre_GCGGAAT_R1.fq	out/sabre_GCGGAAT_R2.fq
GCGT	out/sabre_GCGT_R1.fq	out/sabre_GCGT_R2.fq
GCTCTA	out/sabre_GCTCTA_R1.fq	out/sabre_GCTCTA_R2.fq
GCTGTGGA	out/sabre_GCTGTGGA_R1.fq	out/sabre_GCTGTGGA_R2.fq
GCTTA	out/sabre_GCTTA_R1.fq	out/sabre_GCTTA_R2.fq
GGAAG	out/sabre_GGAAG_R1.fq	out/sabre_GGAAG_R2.fq
GGAAGA	out/sabre_GGAAGA_R1.fq	out/sabre_GGAAGA_R2.fq
GGACCTA	out/sabre_GGACCTA_R1.fq	out/sabre_GGACCTA_R2.fq
GGATTGGT	out/sabre_GGATTGGT_R1.fq	out/sabre_GGATTGGT_R2.fq
GGTGT	out/sabre_GGTGT_R1.fq	out/sabre_GGTGT_R2.fq
GGTTGT	out/sabre_GGTTGT_R1.fq	out/sabre_GGTTGT_R2.fq
GTAA	out/sabre_GTAA_R1.fq	out/sabre_GTAA_R2.fq
GTACTT	out/sabre_GTACTT_R1.fq	out/sabre_GTACTT_R2.fq
GTATT	out/sabre_GTATT_R1.fq	out/sabre_GTATT_R2.fq
GTCAA	out/sabre_GTCAA_R1.fq	out/sabre_GTCAA_R2.fq
GTCGATT	out/sabre_GTCGATT_R1.fq	out/sabre_GTCGATT_R2.fq
GTGAGGGT	out/sabre_GTGAGGGT_R1.fq	out/sabre_GTGAGGGT_R2.fq
GTTGAA	out/sabre_GTTGAA_R1.fq	out/sabre_GTTGAA_R2.fq
TAACGA	out/sabre_TAACGA_R1.fq	out/sabre_TAACGA_R2.fq
TAATA	out/sabre_TAATA_R1.fq	out/sabre_TAATA_R2.fq
TACAT	out/sabre_TACAT_R1.fq	out/sabre_TACAT_R2.fq
TAGCATGG	out/sabre_TAGCATGG_R1.fq	out/sabre_TAGCATGG_R2.fq
TAGCGGA	out/sabre_TAGCGGA_R1.fq	out/sabre_TAGCGGA_R2.fq
TAGGAA	out/sabre_TAGGAA_R1.fq	out/sabre_TAGGAA_R2.fq
TAGGCCAT	out/sabre_TAGGCCAT_R1.fq	out/sabre_TAGGCCAT_R2.fq
TATCGGGA	out/sabre_TATCGGGA_R1.fq	out/sabre_TATCGGGA_R2.fq
TATTTTT	out/sabre_TATTTTT_R1.fq	out/sabre_TATTTTT_R2.fq
TCACG	out/sabre_TCACG_R1.fq	out/sabre_TCACG_R2.fq
TCAG	out/sabre_TCAG_R1.fq	out/sabre_TCAG_R2.fq
TCGAAGA	out/sabre_TCGAAGA_R1.fq	out/sabre_TCGAAGA_R2.fq
TCGTT	out/sabre_TCGTT_R1.fq	out/sabre_TCGTT_R2.fq
TCTCAGTG	out/sabre_TCTCAGTG_R1.fq	out/sabre_TCTCAGTG_R2.fq
TCTGTGA	out/sabre_TCTGTGA_R1.fq	out/sabre_TCTGTGA_R2.fq
TGCA	out/sabre_TGCA_R1.fq	out/sabre_TGCA_R2.fq
TGCAAGGA	out/sabre_TGCAAGGA_R1.fq	out/sabre_TGCAAGGA_R2.fq
TGCGA	out/sabre_TGCGA_R1.fq	out/sabre_TGCGA_R2.fq
TGCTGGA	out/sabre_TGCTGGA_R1.fq	out/sabre_TGCTGGA_R2.fq
TGGCTA	out/sabre_TGGCTA_R1.fq	out/sabre_TGGCTA_R2.fq
TGGTACGT	out/sabre_TGGTACGT_R1.fq	out/sabre_TGGTACGT_R2.fq
TTCAGA	out/sabre_TTCAGA_R1.fq	out/sabre_TTCAGA_R2.fq
TTCCTGGA	out/sabre_TTCCTGGA_R1.fq	out/sabre_TTCCTGGA_R2.fq
TTCTG	out/sabre_TTCTG_R1.fq	out/sabre_TTCTG_R2.fq
